WWWWWWWWWWWWWWWWWWWWWWWWWWWWWWWWWWWWWWWWWWWWWWWWWWWWWWWWWWWWWWWWW
WBBBBBBBWBWBBBBBWBBBBBBBBBBBBBWBBBBBWBBBBBWBBBBBWBBBBBBBWBBBBBBBW
WWWWWWWBWBWBWBWBWBWBWBWWWWWWWBWWWBWBWBWWWBWWWBWBWWWBWWWBWBWWWWWBW
WBBBWBBBWBBBWBWBWBWBWBWBBBBBWBBBWBWBWBBBWBBBBBWBBBWBBBWBBBWBBBWBW
WBWWWBWWWBWWWBWBWWWBWWWBWWWBWWWBWBWBWBWBWWWWWWWWWBWWWBWWWWWBWWWBW
WBWBBBWBBBBBWBWBBBWBBBBBBBWBWBWBWBWBWBWBBBWBBBWBWBBBWBBBBBBBWBBBW
WBWBWWWBWWWWWBWWWBWWWWWWWWWBWBWBWBWBWBWWWBWBWBWBWWWBWWWWWWWWWBWBW
WBBBWBBBWBBBWBWBWBBBBBBBBBBBWBBBWBWBWBBBWBWBWBBBBBWBWBBBBBBBBBWBW
WBWWWWWWWBWBWBWBWWWWWWWWWWWWWBWWWBWBWWWWWBWBWWWWWWWBWBWWWWWWWWWBW
WBWBBBBBWBWBWBWBBBWBBBBBBBWBWBWBBBWBBBBBBBWBWBBBBBBBWBBBWBBBWBBBW
WBWBWWWBWBWBWBWBWWWBWBWWWBWBWBWBWWWWWWWWWWWBWBWWWWWWWWWBWBWBWBWWW
WBBBWBBBWBWBBBWBBBWBWBWBBBBBWBBBWBWBBBBBBBWBBBWBBBBBBBBBWBWBBBWBW
WWWWWBWWWBWWWWWBWBWBWBWWWWWBWWWWWBWBWBWWWBWBWWWWWBWWWBWWWWWWWBWBW
WBBBWBBBBBWBBBWBWBBBWBBBBBWBWBBBBBBBWBWBBBWBBBBBWBWBBBWBBBBBWBBBW
WBWWWWWWWWWBWBWWWWWWWBWWWBWBWWWWWWWBWBWWWWWWWWWBWBWBWBWBWWWBWWWBW
WBWBBBBBBBBBWBWBBBBBWBBBWBWBWBBBBBWBWBBBWBBBBBBBWBWBWBWBWBBBWBBBW
WBWBWWWWWWWBWBWBWWWBWWWWWBWBWBWWWBWWWWWBWBWWWWWWWWWBWBWBWBWBWWWWW
WBWBWBWBBBWBWBBBWBWBBBBBWBWBWBBBWBWBBBWBWBBBWBBBBBBBWBWBWBWBWBBBW
WBWBWBWBWBWBWWWWWBWWWWWBWBWBWWWBWBWBWBWBWWWBWBWWWWWWWBWBWBWBWBWBW
WBWBBBWBWBWBBBBBWBBBBBBBBBWBWBBBWBWBWBBBWBBBWBBBBBBBWBWBWBWBWBWBW
WBWBWWWBWBWWWBWBWWWWWBWWWWWBWBWWWBWBWWWBWBWWWBWWWWWBWWWBWBWWWBWBW
WBBBWBBBWBBBWBWBWBBBWBWBBBWBBBWBBBWBWBBBWBWBBBBBBBWBBBBBWBBBBBWBW
WBWWWBWWWWWBWWWBWBWBWWWBWBWWWWWBWWWBWWWBWBWWWWWWWBWWWWWWWWWWWWWBW
WBWBWBBBWBWBBBWBBBWBBBWBWBWBWBBBWBWBBBWBWBBBBBWBWBWBBBBBWBWBBBBBW
WBWBWWWBWBWWWBWWWWWWWBWBWBWBWBWWWBWBWBWWWWWWWBWBWBWBWWWBWBWBWWWWW
WBWBBBWBWBWBBBWBBBBBWBBBWBWBBBWBBBWBWBBBBBBBWBWBBBBBWBBBBBWBWBBBW
WBWWWBWBWBWBWWWBWWWBWWWWWBWBWWWWWBWBWWWWWBWBWBWWWWWWWWWWWBWBWBWBW
WBBBBBWBWBWBBBBBWBWBBBWBBBWBWBBBWBBBWBBBBBWBWBWBBBWBBBBBWBWBBBWBW
WWWWWWWBWBWWWWWWWBWWWBWBWWWBWBWBWWWWWBWBWWWWWBWBWBWBWWWBWWWWWWWBW
WBBBBBBBWBBBBBBBBBBBWBBBWBWBBBWBBBBBBBWBWBBBWBBBWBBBWBWBBBBBWBBBW
WBWWWWWWWBWWWWWBWWWWWWWWWBWWWWWWWWWWWWWBWBWBWWWWWWWWWBWWWWWBWBWBW
WBBBWBBBBBBBWBBBWBBBBBBBBBBBBBBBBBWBBBBBWBWBWBBBBBBBBBWBBBWBBBWBW
WBWBWWWWWWWBWWWWWBWWWWWWWWWWWWWWWBWBWWWWWBWBWBWBWWWWWBWBWWWWWWWBW
WBWBBBBBBBWBBBBBWBWBBBBBBBBBWBBBWBBBWBBBBBWBWBWBWBBBBBWBBBBBWBBBW
WBWWWWWWWBWBWWWBWBWWWBWWWWWBWBWBWWWWWBWWWWWBWBWBWWWWWBWWWBWBWBWWW
WBWBBBWBBBWBWBWBWBWBBBWBWBBBWBWBBBWBWBWBBBWBBBWBWBBBWBBBWBWBWBBBW
WBWBWBWBWWWBWBWBWBWBWWWBWBWWWWWBWBWBWBWBWBWWWWWBWBWBWWWBWWWBWWWBW
WBWBWBWBWBBBWBWBBBWBBBWBBBWBBBWBWBBBWBWBWBBBBBWBBBWBBBWBBBBBWBBBW
WWWBWBWBWBWWWBWWWWWWWBWBWWWBWBWBWWWBWBWBWBWWWWWWWWWWWBWWWWWBWBWWW
WBBBWBWBWBBBWBBBBBBBBBWBWBBBWBWBWBWBWBWBWBWBBBBBBBBBWBBBWBBBWBWBW
WBWWWBWBWWWBWWWWWBWWWWWBWBWWWBWBWBWBWBWBWWWBWWWWWWWBWWWBWBWWWBWBW
WBWBWBBBWBWBBBBBBBWBBBWBBBWBBBBBWBBBWBWBWBBBWBBBWBWBBBWBWBBBWBWBW
WBWBWWWWWBWWWWWWWWWBWBWWWBWWWWWWWWWWWBWBWBWWWBWBWBWWWBWBWBWWWBWBW
WBWBBBBBBBWBBBWBBBBBWBBBWBWBBBBBBBBBWBWBWBBBBBWBWBBBBBBBWBWBBBWBW
WBWBWWWWWBWBWBWBWWWWWBWWWBWBWWWWWWWBWBWBWWWWWWWBWWWWWWWWWBWBWWWBW
WBWBWBBBWBBBWBBBWBBBWBWBBBWBBBBBBBWBWBWBBBBBBBWBBBBBBBWBWBWBWBBBW
WBWWWBWBWWWBWWWWWBWBWBWBWWWWWBWWWWWBWBWBWBWWWWWWWWWWWBWBWBWBWWWBW
WBWBBBWBBBWBWBBBWBWBWBBBWBBBBBWBBBBBWBWBWBBBWBBBBBBBWBWBBBWBBBWBW
WBWBWWWWWBWBWBWWWBWBWWWWWBWWWWWBWWWWWBWBWWWBWBWWWWWBWBWWWWWWWBWBW
WBWBWBWBBBWBWBWBBBWBWBBBBBWBBBWBBBBBBBWBWBBBWBBBBBWBBBWBBBBBWBWBW
WBWBWBWBWWWBWBWBWWWBWBWWWWWBWWWWWWWWWWWWWBWBWWWWWBWBWWWBWBWWWBWBW
WBBBWBWBBBWBBBWBWBWBBBWBBBBBWBBBBBBBWBBBBBWBWBBBBBWBWBBBWBBBBBWBW
WBWWWBWWWBWBWWWBWBWWWWWBWBWWWBWBWWWBWWWBWWWWWBWWWWWBWBWWWWWWWWWBW
WBWBBBWBBBWBWBBBWBBBBBWBWBWBBBWBBBWBWBBBWBBBWBWBWBBBWBBBWBBBBBBBW
WBWBWBWBWWWWWBWWWBWBWBWWWBWBWWWWWBWBWBWBWBWBWBWBWBWWWWWBWWWWWBWBW
WBBBWBWBBBBBWBWBBBWBWBBBWBBBWBBBWBWBBBWBWBWBBBWBWBWBBBWBBBBBWBWBW
WWWWWBWWWWWBWBWWWWWBWWWBWWWWWBWBWBWWWWWBWBWWWWWBWBWBWWWWWWWBWBWBW
WBBBWBBBWBBBWBBBBBBBWBWBBBBBBBWBBBWBBBWBWBBBBBWBWBWBBBBBBBWBWBWBW
WBWWWWWBWBWWWWWWWWWWWBWWWWWWWWWWWWWWWBWBWWWWWBWBWBWWWBWWWBWBWBWBW
WBWBBBBBWBBBBBWBBBBBBBBBBBWBBBBBBBBBWBWBWBBBWBWBBBBBWBBBWBWBBBWBW
WBWBWWWWWWWBWBWBWWWWWBWWWBWBWBWWWWWBWBWBWBWBWBWWWWWBWWWBWWWWWWWBW
WBWBBBBBWBWBWBWBWBBBBBWBBBWBWBWBBBWBBBWBWBWBWBBBWBBBBBBBWBBBWBBBW
WBWWWWWBWBWBWWWBWBWWWWWWWWWBWBWBWBWWWWWBWBWBWWWBWWWWWWWWWBWBWBWWW
WBBBBBBBBBWBBBBBWBBBBBBBBBBBWBBBWBBBBBBBBBWBBBWBBBBBBBBBBBWBBBBBW
WWWWWWWWWWWWWWWWWWWWWWWWWWWWWWWWWWWWWWWWWWWWWWWWWWWWWWWWWWWWWWWWW