WWWWWWWWWWWWWWWWWWWWWWWWWWWWWWWWW
WBWBBBWBBBBBBBBBBBBBWBBBBBWBBBBBW
WBWBWBWBWWWWWWWWWWWBWBWBWBWWWBWBW
WBWBWBBBWBBBWBBBBBWBBBWBWBBBWBWBW
WBWBWWWWWBWWWBWWWBWWWWWBWWWBWWWBW
WBWBBBBBBBWBBBWBBBWBBBBBWBBBBBBBW
WBWBWWWWWWWBWWWBWWWBWWWWWBWWWWWWW
WBWBWBBBBBBBWBWBWBBBWBBBWBWBBBBBW
WBWWWBWWWWWWWBWBWBWBWBWBWBWBWWWBW
WBBBWBWBBBBBBBBBWBWBWBWBBBWBWBBBW
WWWBWBWBWWWWWWWWWBWBWWWWWWWBWBWBW
WBWBBBWBBBWBBBBBWBWBBBBBBBBBWBWBW
WBWWWWWWWBWBWWWBWWWBWWWWWWWWWBWWW
WBBBBBBBWBWBWBBBBBWBBBBBBBBBWBBBW
WBWWWWWBWBWBWWWWWBWWWWWWWBWWWWWBW
WBWBBBWBWBWBBBWBWBBBWBBBBBWBBBWBW
WBWBWBWBWBWWWBWBWWWBWWWWWWWBWBWBW
WBBBWBWBWBBBWBWBBBWBBBWBBBBBWBWBW
WBWWWBWBWWWBWBWWWBWWWBWBWWWWWBWBW
WBBBWBWBWBBBWBBBWBBBBBWBWBBBWBWBW
WWWBWBWWWBWWWBWBWBWWWWWBWWWBWBWBW
WBWBWBBBWBWBBBWBWBWBBBBBBBWBBBBBW
WBWBWWWBWBWWWWWBWBWWWBWWWBWWWWWBW
WBBBWBBBWBBBWBBBWBBBWBBBWBBBBBWBW
WWWWWBWBWWWBWBWWWWWBWWWBWWWWWBWWW
WBBBBBWBBBWBWBWBBBWBBBWBWBBBWBBBW
WBWWWWWWWWWBWBWBWWWWWBWWWBWBWBWBW
WBBBWBBBBBWBBBWBBBBBWBWBBBWBWBWBW
WWWBWBWWWBWWWWWBWBWWWBWBWWWBWWWBW
WBBBWBWBWBBBBBWBWBBBWBWBBBWBBBWBW
WBWWWBWBWWWWWBWBWWWBWBWWWBWWWBWBW
WBBBBBBBBBBBWBBBBBWBBBBBBBWBBBBBW
WWWWWWWWWWWWWWWWWWWWWWWWWWWWWWWWW