WWWWWWWWWWWWWWWWWWWWWWWWWWWWWWWWWWWWWWWWWWWWWWWWWWWWWWWWWWWWWWWWWWWWWWWWWWWWWWWWWWWWWWWWWWWWWWWWWWWWW
WBWBBBBBBBBBBBWBBBWBBBBBBBWBBBBBBBBBWBBBBBWBBBWBBBBBWBBBWBBBBBWBBBWBBBBBWBBBWBBBBBBBBBBBBBBBWBWBBBBBW
WBWWWWWWWWWBWBWBWBWBWWWBWBWBWWWBWWWBWWWBWBWBWBWWWBWBWBWBWWWBWBWBWBWBWBWBWBWWWBWWWWWWWBWWWWWBWBWBWWWBW
WBBBWBBBBBWBWBBBWBBBWBBBWBWBWBBBWBWBWBBBWBWBWBBBWBWBBBWBBBBBWBWBWBWBWBWBWBBBWBBBBBBBWBBBWBWBBBWBWBBBW
WWWBWBWWWBWWWWWWWWWWWBWBWWWBWBWWWBWBWBWWWBWBWWWBWBWWWWWWWWWWWBWBWBWWWBWBWWWBWBWWWWWWWWWBWBWWWBWBWBWBW
WBWBWBBBWBBBBBWBBBBBWBWBWBBBWBWBBBWBWBBBWBBBWBWBBBWBBBBBBBBBWBBBWBBBBBWBBBWBWBWBBBBBBBWBWBBBBBWBWBWBW
WBWBWBWBWWWWWBWBWWWBWBWWWBWWWBWBWBWBWWWBWWWWWBWWWWWBWBWWWWWWWWWWWWWWWWWWWBWBWBWBWWWWWBWBWWWWWWWBWBWWW
WBBBWBWBWBBBBBBBWBWBWBBBBBWBBBWBWBWBBBWBBBWBBBBBBBWBWBBBWBBBBBBBWBBBBBWBBBBBWBWBBBBBWBBBWBBBBBBBWBBBW
WBWWWBWBWWWBWWWWWBWBWWWWWWWBWWWBWBWWWBWBWBWBWWWBWWWBWWWBWBWBWBWWWBWWWBWBWWWWWBWWWWWBWWWBWBWWWWWWWWWBW
WBBBWBWBBBWBWBBBWBBBWBBBBBWBBBWBWBBBWBWBWBWBBBWBBBBBWBWBBBWBWBWBBBWBWBBBWBBBBBWBBBWBWBBBWBBBBBWBBBBBW
WWWBWWWBWBWWWBWBWBWWWBWWWBWWWBWBWWWBWBWBWBWWWBWWWWWWWBWWWWWBWWWBWWWBWWWWWBWWWWWBWBWBWWWBWWWWWBWBWWWBW
WBWBBBWBWBBBBBWBWBWBBBWBWBBBBBWBWBBBWBWBWBWBBBBBWBBBBBBBBBWBBBBBBBBBWBBBWBWBBBBBWBWBBBWBBBWBBBWBWBWBW
WBWWWBWWWWWWWWWBWBWBWWWBWWWWWWWBWBWWWBWWWBWWWWWBWBWBWWWWWWWWWWWWWWWBWBWBWBWWWBWWWBWWWBWWWWWBWWWBWBWBW
WBBBWBWBBBBBBBWBWBBBWBBBBBWBBBWBWBBBWBBBWBBBBBWBBBWBWBBBBBBBBBWBBBBBBBWBWBBBBBWBBBBBWBBBBBWBBBWBWBWBW
WBWWWBWBWWWWWBWBWWWWWBWWWBWBWBWBWWWBWWWBWBWWWBWWWWWBWBWWWWWWWBWWWWWWWWWBWWWWWBWWWWWWWWWWWBWBWWWBWBWBW
WBBBBBWBBBBBWBWBBBWBWBBBWBBBWBWBWBWBWBBBWBBBWBWBBBWBWBWBBBBBWBBBBBBBBBWBBBWBBBWBBBBBBBBBBBWBWBBBWBWBW
WBWWWWWWWWWBWBWWWBWBWWWBWWWWWBWBWBWBWBWWWWWWWBWBWBWWWBWBWWWBWWWWWWWWWBWWWBWBWWWBWBWWWWWWWWWBWBWWWBWBW
WBBBBBWBBBBBWBWBBBWBBBBBWBBBWBBBWBWBBBWBBBBBWBBBWBBBWBBBWBBBBBBBBBBBWBWBBBWBWBBBWBWBBBWBBBBBWBBBWBBBW
WWWWWBWBWWWWWBWBWWWBWWWWWWWBWWWWWBWWWWWWWBWBWWWWWWWBWWWWWBWWWWWWWWWBWBWWWWWBWBWWWWWBWBWBWWWWWWWBWWWWW
WBBBWBBBWBBBWBWBWBBBWBBBBBBBWBBBBBBBBBWBBBWBWBBBBBBBBBWBBBBBWBBBBBWBWBBBBBBBWBWBBBBBWBWBBBWBBBWBBBBBW
WBWWWWWWWBWWWBWBWWWBWWWBWWWBWBWBWWWWWBWBWWWBWBWWWWWWWWWBWWWWWBWWWBWBWWWWWWWWWBWBWWWWWBWWWBWBWBWWWWWBW
WBWBBBBBBBBBBBWBBBWBBBBBWBWBWBWBWBBBBBWBWBWBWBBBWBBBBBBBWBBBWBWBBBWBWBBBBBBBBBWBWBBBWBBBBBWBWBBBWBBBW
WBWBWWWWWWWWWWWBWBWWWWWWWBWBWWWBWBWWWWWBWBWBWBWBWBWWWWWWWBWBWBWBWWWWWBWWWWWWWBWBWBWBWWWWWWWWWWWBWBWWW
WBWBBBBBWBBBBBWBWBBBWBWBBBWBWBBBWBBBBBBBWBBBWBWBBBWBBBBBBBWBBBWBBBWBBBWBBBWBWBWBBBWBBBWBWBBBBBWBWBBBW
WBWWWWWBWWWBWBWBWWWBWBWBWBWBWBWWWWWWWWWWWBWWWBWWWWWBWWWWWWWWWWWWWBWBWWWBWBWBWBWWWWWWWBWBWBWBWBWBWWWBW
WBBBBBWBBBBBWBWBWBBBWBBBWBBBWBBBBBWBBBBBWBWBWBBBWBWBBBWBBBBBWBBBWBWBBBBBWBWBBBBBWBBBBBWBBBWBWBWBBBWBW
WBWWWWWWWWWWWBWWWBWWWBWWWWWWWWWWWBWBWWWBWBWBWWWBWBWWWBWBWWWBWBWBWBWBWWWWWBWWWWWBWBWWWWWBWWWBWBWBWWWBW
WBBBBBBBBBBBWBBBWBBBWBWBBBWBBBBBBBWBWBWBWBWBBBWBBBWBWBWBBBWBBBWBWBWBBBBBWBBBBBWBWBWBBBBBWBBBWBBBWBBBW
WWWWWWWBWBWWWWWBWBWBWBWBWBWWWBWWWWWBWBWBWBWBWWWWWBWBWBWWWBWWWWWBWBWWWWWWWBWWWBWBWBWBWWWWWBWWWBWWWBWBW
WBBBBBWBWBWBBBBBWBWBWBBBWBBBBBWBWBBBWBWBWBWBBBBBWBBBWBBBBBWBBBBBWBBBBBBBWBWBBBWBWBWBBBWBWBWBBBWBBBWBW
WBWWWBWBWBWBWWWWWWWBWWWWWWWWWWWBWBWWWBWBWBWBWBWBWWWBWWWWWWWBWWWWWWWWWWWBWWWBWWWWWBWWWBWBWBWWWWWBWWWWW
WBWBBBBBWBWBBBBBBBBBWBBBBBBBBBBBWBWBBBWBWBWBWBWBBBWBBBBBWBBBWBBBWBBBWBBBWBBBWBBBBBWBBBBBWBBBBBWBWBBBW
WBWWWWWWWWWWWWWWWWWWWWWBWWWWWWWWWBWBWBWBWBWWWBWWWWWWWWWBWBWWWBWBWBWBWBWWWBWWWBWWWWWWWWWWWWWBWBWBWBWBW
WBBBWBBBBBBBWBBBBBBBBBWBWBBBBBBBWBWBWBWBWBBBWBBBBBBBBBBBWBBBWBWBBBWBBBWBWBBBWBWBBBBBBBBBBBWBWBWBBBWBW
WBWBWBWWWBWWWBWWWBWWWBWBWBWWWWWBWBWBWWWBWWWBWWWWWWWWWBWWWWWBWBWWWWWWWWWBWBWBWBWBWBWWWWWWWBWWWBWWWWWBW
WBWBWBWBWBBBWBWBWBWBBBWBBBWBBBWBBBWBWBBBBBWBBBBBWBBBWBBBBBWBWBWBBBBBBBWBBBWBBBWBWBWBBBBBWBBBWBWBBBBBW
WBWBWBWBWWWBWBWBWBWBWWWBWWWBWBWWWWWBWBWWWBWWWWWBWBWBWWWWWWWBWBWWWBWWWBWBWWWWWWWWWBWWWBWBWWWBWBWBWWWBW
WBWBBBWBBBWBBBWBWBWBBBWBBBBBWBBBBBBBWBWBBBBBWBWBBBWBBBBBBBBBWBBBWBWBBBWBWBBBBBBBWBBBWBWBBBBBWBWBBBWBW
WBWWWWWBWWWWWWWBWBWWWBWWWWWWWWWWWWWBWBWWWWWBWBWWWWWWWWWWWWWWWWWBWBWWWBWBWWWWWBWBWWWBWWWWWWWBWBWWWBWWW
WBBBWBBBBBBBWBBBWBWBBBWBBBBBWBBBBBWBWBWBBBWBBBWBBBBBBBBBBBWBBBWBWBBBWBWBBBBBBBWBBBWBWBBBBBWBWBBBWBBBW
WWWBWWWWWBWBWWWBWBWWWBWBWWWBWBWWWBWBWBWBWBWWWBWBWWWWWWWWWBWBWBWBWBWBWWWWWWWWWWWWWBWBWBWWWBWBWWWBWWWBW
WBBBBBBBBBWBBBBBWBBBWBWBWBWBWBWBBBWBWBBBWBBBWBWBBBBBBBBBWBBBWBWBWBWBWBBBBBWBBBBBBBWBBBWBBBWBBBBBWBWBW
WBWWWWWWWWWWWWWBWWWBWBWBWBWBWBWBWWWWWWWWWWWBWBWBWWWWWWWBWBWWWWWBWBWBWBWBWWWBWWWWWWWBWWWBWWWWWWWBWBWBW
WBBBWBBBBBBBWBBBWBWBWBBBWBWBBBWBBBWBBBBBBBBBWBWBBBBBWBBBWBWBBBWBWBWBBBWBBBBBWBBBBBWBWBBBWBBBBBBBBBWBW
WWWWWBWWWWWBWWWBWBWBWWWWWBWWWWWWWBWBWWWWWWWWWBWWWWWWWBWWWBWBWBWBWWWWWWWBWWWWWBWWWBWWWBWWWBWWWWWWWWWBW
WBBBBBWBBBWBBBWBBBWBWBBBBBBBWBBBWBWBWBWBBBBBWBWBBBBBBBWBWBWBWBBBWBBBBBWBBBBBWBBBWBBBBBWBWBBBBBWBBBBBW
WBWWWWWBWWWWWBWWWBWBWWWWWBWBWBWBWBWBWBWBWBWBWBWBWWWWWWWBWBWBWWWWWBWWWBWWWWWBWWWBWWWWWWWBWBWWWWWBWWWWW
WBWBBBBBBBBBWBBBWBWBBBBBWBWBWBWBBBBBWBBBWBWBWBWBBBWBBBBBWBWBWBBBWBBBWBBBWBWBBBBBWBBBBBWBBBWBBBWBBBBBW
WBWWWWWWWBWWWWWBWWWWWWWBWBWWWBWWWWWWWWWBWBWBWBWWWBWBWBWWWBWBWBWBWBWBWWWBWBWWWWWWWBWWWBWBWWWBWBWWWWWBW
WBBBBBBBWBBBBBWBBBWBBBBBWBWBBBWBBBBBBBWBWBWBWBBBBBWBWBWBBBWBBBWBWBWBWBBBWBBBWBBBBBWBWBBBWBWBWBBBBBWBW
WBWWWWWBWWWWWBWWWBWBWWWWWBWBWWWBWWWWWBWBWBWWWWWWWWWBWWWBWWWWWWWBWWWBWBWWWWWBWBWWWWWBWWWWWBWBWWWWWBWBW
WBWBBBWBWBBBBBBBWBWBWBBBWBWBBBWBWBBBWBWBWBWBBBBBBBWBBBBBWBBBBBWBWBBBWBWBBBBBWBBBBBBBBBBBBBWBBBBBWBWBW
WBWBWWWBWBWWWBWWWBWBWBWBWBWBWWWBWBWBWBWWWBWBWWWBWWWBWWWWWBWBWWWBWBWWWBWWWBWWWWWWWWWBWWWWWWWWWBWBWBWBW
WBBBWBBBWBWBBBWBBBWBBBWBWBBBWBBBWBWBWBBBWBBBBBWBBBWBBBWBBBWBWBBBWBBBWBBBWBWBBBBBBBBBWBBBBBBBWBWBWBBBW
WWWBWBWWWBWWWWWBWWWWWWWBWBWWWBWWWBWBWWWBWWWWWWWBWBWWWBWBWWWBWBWWWWWBWWWBWBWBWWWWWWWWWBWWWWWBWWWBWWWBW
WBBBWBBBWBWBBBWBWBBBBBWBWBBBWBWBBBWBWBWBWBBBBBWBWBBBBBWBBBWBWBWBBBBBWBWBWBBBWBBBBBBBBBWBBBWBBBBBWBBBW
WBWWWWWBWBWBWBWBWWWBWBWBWWWBWBWBWWWBWBWBWBWWWBWBWWWWWWWWWBWBWBWBWWWWWBWBWWWBWBWWWWWWWWWBWBWWWWWWWBWWW
WBWBBBBBWBBBWBWBBBBBWBBBWBWBWBBBWBWBBBWBWBBBWBWBBBBBBBBBWBWBBBWBWBBBBBWBBBWBWBWBBBWBBBWBWBBBBBBBBBWBW
WBWBWWWWWBWWWBWWWWWWWWWWWBWBWWWWWBWWWBWBWWWBWBWWWWWWWWWBWBWWWWWBWBWBWBWWWBWWWBWBWWWBWBWBWWWWWWWWWWWBW
WBWBWBBBWBBBWBBBBBBBBBBBBBWBBBBBBBWBBBWBBBWBWBWBBBBBWBBBWBWBBBBBWBWBWBBBWBBBBBWBBBWBWBBBWBBBBBWBBBBBW
WBWBWBWBWWWBWWWWWBWWWBWWWWWWWWWBWWWBWWWBWBWBWBWBWWWBWBWWWBWWWWWBWBWBWWWWWWWWWWWBWBWBWWWWWWWBWBWWWBWBW
WBWBWBWBBBWBWBBBWBBBWBWBBBBBBBWBWBBBWBBBWBWBWBWBBBWBBBBBWBBBBBBBWBWBBBBBBBWBBBWBWBBBWBBBBBBBWBBBWBWBW
WBWBWBWWWWWBWBWWWWWBWWWBWBWBWWWBWBWWWBWWWWWBWBWWWWWWWWWBWWWWWWWWWWWWWWWBWBWBWBWBWWWWWBWWWWWWWWWBWBWBW
WBWBWBBBBBBBWBBBWBBBWBBBWBWBWBBBWBWBWBBBBBBBWBBBBBWBBBWBBBBBBBBBWBBBWBBBWBWBWBWBWBBBBBWBBBBBWBBBWBWBW
WBWBWBWWWWWBWWWBWBWWWBWWWBWBWBWWWBWBWWWWWWWWWWWWWBWBWBWWWWWWWWWBWBWBWBWWWBWBWBWBWWWWWBWWWBWWWBWWWBWBW
WBWBWBWBBBWBBBBBWBWBBBWBBBWBWBWBBBWBBBBBBBBBBBWBWBBBWBWBBBBBBBWBWBWBBBWBBBWBWBBBWBBBBBWBBBWBBBWBBBWBW
WBWBWWWBWBWWWWWWWBWBWWWBWWWWWBWBWWWWWBWBWWWWWBWBWWWWWBWBWWWBWWWBWBWWWWWBWWWBWWWWWBWWWWWBWBWBWWWWWWWBW
WBWBWBBBWBBBBBBBWBBBBBWBBBWBBBWBWBBBWBWBWBBBWBBBWBBBWBWBBBWBWBBBWBBBWBBBWBBBWBWBBBWBBBBBWBWBWBBBBBBBW
WWWBWBWWWWWWWWWBWWWWWWWWWBWBWWWBWBWBWWWBWWWBWWWBWWWBWBWWWBWWWBWWWBWBWWWBWBWWWBWBWBWBWBWWWWWBWWWBWWWBW
WBBBWBWBBBBBBBWBBBBBWBBBWBBBBBWBWBWBBBBBWBBBWBWBBBWBWBWBBBWBBBWBWBWBBBWBWBBBWBWBWBWBWBWBBBBBWBBBWBBBW
WBWWWBWBWWWWWBWBWWWBWBWBWWWWWBWBWBWWWWWWWBWBWBWWWBWBWBWBWBWBWWWBWBWWWBWBWWWBWBWBWBWBWBWBWWWWWBWWWWWWW
WBWBBBWBWBBBWBWBBBWBBBWBWBBBWBWBWBBBWBBBBBWBBBBBWBBBWBWBWBWBWBBBBBBBWBWBBBWBWBBBWBWBWBBBWBWBBBBBBBBBW
WBWBWWWBWWWBWBWBWWWWWWWBWBWBWWWBWWWBWBWWWWWWWWWBWWWBWBWBWWWBWWWWWWWWWBWWWBWBWWWWWBWBWWWWWBWBWWWWWWWBW
WBBBBBWBBBWBBBWBWBBBBBBBWBWBBBWBBBWBWBBBBBBBBBWBWBBBWBWBBBBBBBWBBBBBBBWBBBWBBBBBBBWBBBWBBBBBBBBBWBBBW
WWWWWWWWWBWWWBWWWBWBWWWWWBWWWBWWWBWBWBWWWWWWWBWBWBWWWBWWWWWWWBWBWWWWWWWBWWWWWWWWWWWWWBWWWWWWWBWWWBWBW
WBBBBBBBWBBBWBBBWBWBWBBBWBBBWBBBWBBBWBBBBBBBWBWBWBBBWBBBBBWBWBWBBBBBWBBBWBBBBBWBBBBBWBBBBBWBBBWBBBWBW
WBWWWWWBWWWBWWWBWBWWWBWBWWWBWWWBWBWWWWWWWWWWWBWBWWWBWWWWWBWBWBWWWWWBWBWWWWWWWBWBWBWWWWWWWBWWWBWBWWWBW
WBWBBBBBBBWBBBWBBBWBBBWBBBBBBBWBBBWBBBBBBBWBBBWBBBWBWBBBWBWBBBBBBBBBWBWBBBBBBBWBWBBBBBBBWBBBWBWBWBBBW
WBWWWWWWWBWWWBWWWWWBWWWWWWWWWWWWWWWBWWWWWBWBWWWWWWWBWBWWWBWBWWWWWWWWWBWBWWWWWWWBWWWWWWWBWWWBWWWBWWWWW
WBWBBBWBBBBBBBWBBBBBBBBBWBBBBBBBBBBBWBWBBBWBBBWBBBBBWBBBWBWBWBBBBBBBWBWBBBWBBBBBBBWBBBWBBBWBWBBBWBBBW
WBWBWBWBWWWWWWWBWWWWWWWWWBWWWWWWWWWWWBWBWWWBWBWBWWWWWWWBWBWWWBWWWWWBWBWWWBWBWWWWWWWBWBWBWWWBWBWWWBWBW
WBBBWBWBBBWBBBBBWBBBWBBBBBWBBBBBBBBBBBBBBBWBWBWBBBWBBBBBWBWBBBWBWBBBWBBBWBBBBBBBWBBBWBBBWBBBWBBBBBWBW
WBWWWBWWWWWBWWWWWWWBWBWWWWWBWWWWWWWWWWWWWBWWWBWWWBWBWWWBWBWBWWWBWBWWWWWBWWWWWBWWWBWBWWWWWBWWWWWWWWWBW
WBBBWBBBBBWBBBBBBBWBWBWBBBBBBBBBBBWBBBBBWBBBWBBBBBBBWBBBWBWBWBBBWBBBWBBBBBWBBBWBBBWBWBBBBBWBBBBBWBBBW
WWWBWWWWWBWWWWWWWBWBWBWWWBWWWWWWWWWBWWWBWWWBWWWWWBWWWWWWWBWBWBWWWWWBWWWWWBWWWWWBWWWBWBWWWWWBWWWBWBWBW
WBBBBBWBBBWBBBWBBBWBWBBBWBWBBBBBBBBBWBWBBBWBBBBBWBWBBBBBBBWBWBBBBBWBBBWBBBBBBBWBWBBBWBWBBBWBBBWBBBWBW
WBWWWWWBWBWBWWWBWWWBWWWBWWWBWWWWWWWWWBWWWBWWWWWBWBWBWWWWWWWBWBWWWBWWWBWWWWWWWBWBWWWBWBWBWBWWWBWWWWWBW
WBBBWBBBWBBBWBBBWBBBBBWBBBWBWBBBBBBBBBBBWBBBBBWBWBWBBBWBBBBBWBBBWBBBWBBBWBBBWBWBBBWBWBBBWBBBWBBBBBWBW
WWWBWBWWWWWWWBWWWWWWWBWWWBWBWWWWWBWWWWWBWWWWWBWBWWWBWBWBWWWWWWWBWBWBWWWBWBWWWBWWWBWBWWWWWWWBWWWWWBWBW
WBWBWBBBWBBBBBWBBBBBBBBBWBWBBBWBBBWBWBBBWBBBWBWBBBWBWBWBWBBBBBWBWBWBBBWBWBBBBBBBBBWBWBBBBBWBBBWBBBWBW
WBWBWWWBWBWWWWWBWBWBWWWWWBWWWBWBWWWBWBWWWBWBWBWWWBWWWBWBWWWBWBWBWBWWWWWBWWWWWWWWWWWBWBWBWBWWWBWBWWWWW
WBWBWBBBWBWBWBBBWBWBWBBBBBWBBBWBBBWBBBWBBBWBBBWBBBWBBBWBBBWBWBWBWBBBBBWBBBWBBBBBWBWBWBWBWBWBBBWBBBBBW
WBWBWBWWWBWBWBWWWBWBWBWWWBWBWWWWWBWBWWWBWWWWWWWBWWWBWBWWWBWBWBWWWBWWWBWWWBWBWWWBWBWBWWWBWWWBWWWWWWWBW
WBWBWBBBWBWBBBWBBBWBWBWBBBWBBBBBBBWBWBBBWBBBBBWBBBBBWBBBWBBBWBBBWBWBWBWBBBWBBBWBWBBBBBBBWBBBWBBBBBBBW
WBWBWWWBWBWWWBWBWWWWWBWBWWWWWWWWWWWBWBWWWBWWWBWWWBWWWWWBWWWWWWWBWBWBWBWBWBWWWBWBWWWWWWWBWBWWWBWWWWWBW
WBWBWBWBWBBBWBWBWBBBWBWBWBBBBBWBBBBBWBWBBBWBWBWBBBWBBBWBBBWBBBWBWBBBWBWBWBBBWBWBBBWBBBBBWBWBBBBBBBWBW
WBWBWBWBWWWBWWWBWBWBWBWWWBWWWBWBWWWWWBWBWWWBWBWWWWWBWBWWWWWBWBWBWWWWWBWBWWWWWBWWWBWWWWWWWBWWWBWWWBWBW
WBWBBBWBBBWBBBWBBBWBWBBBBBWBBBWBBBWBWBWBWBBBWBBBBBBBWBBBBBBBWBWBWBBBWBWBBBBBWBBBWBBBBBBBWBBBWBBBWBWBW
WBWWWBWWWBWWWBWWWWWBWWWWWWWBWWWWWBWBWBWBWWWBWWWWWWWWWWWWWWWWWBWBWBWBWBWWWWWBWWWBWWWWWWWBWWWBWWWWWBWBW
WBBBBBBBWBBBBBBBBBBBBBBBBBWBBBBBBBBBWBBBBBBBBBBBBBBBBBBBBBBBWBBBBBWBBBBBBBWBBBBBBBBBBBWBBBBBBBBBBBWBW
WWWWWWWWWWWWWWWWWWWWWWWWWWWWWWWWWWWWWWWWWWWWWWWWWWWWWWWWWWWWWWWWWWWWWWWWWWWWWWWWWWWWWWWWWWWWWWWWWWWWW